PPPPPPPPPPPPPPPPPPPP
PPPPPPPPPPPPPPPPCPPP
PPPPPPPPPPPPPPPPCPPP
PPPPPPPPPPPPPPPP PPP
PP            K L PP
PPPPPPPPPPPPPPPP PPP
PP                PP
PP               EPP
PP               PPP
PP                PP
PP    *           PP
PP                PP
PP                PP
PP  C     P       PP
PPPPPPPPPPPPPPPPPPPP
PPPPPPPPPPPPPPPPPPPP