PPPPPPPPPPPPPPPPPPPPPPPPPPP
PPPPPPPPPPPPPPPPPPPPPPPPPPP
PPPPPPPPPPPPPPPPPPPPPPPCPPP
PPPPPPPPPPPPPPPPPPPPPPPCPPP
PP              K      L PP
PPPPPPPPPPPPPPPPPPPPPPP PPP
PP                       PP
PP                      EPP
PP                      PPP
PP                       PP
PP        *              PP
PP                       PP
PP                       PP
PP     C          P      PP
PPPPPPPPPPPPPPPPPPPPPPPPPPP
PPPPPPPPPPPPPPPPPPPPPPPPPPP